R 800 600
NO ./images/dog.xpm
EA ./images/lamp.xpm
WE ./images/citizen.xpm
SO ./images/diamond_wall.xpm

S ./images/armor.xpm
F 137,63,69
C 0,191,255

11111111111111111111111111111
10000000001100000000000000021
10110000011100000100000E10001
10010000000000000000000010001
10110000011100000000000010001
10000000001100000111011110001
11110111111111011100000010201
11110111111111011101010010001
11000000110101011100000011011
10000000000000001100000011011
10000000000000001101010011011
11000000110101011111011111011
11110111111101011111011111011
11111111111111111111111111111